111111111111111111111
1C000E001100000110001
11000P1100V0000000001
10V0000C000V000C11C01
11000V0000V000000C101
1000111C00000011C1101
10000000C110000000V01
111111111111111111111