11111111
1000E001
11C00P11
11111111