111111111111
1000E0011001
11000P1100V1
10V0000C0001
11000V000001
10000CV00001
100V00000V01
100000000001
10000C000001
111111111111