111111111111
1P00E0011001
1100001100V1
10V0a00C0001
11000V000001
111111111111