111111111111
1000E0011001
11E00P1100V1
10V0000C0001
110P0V000001
111111111111