111111111111
1PC0E0011001
100000000001
100000000001
11111111111