1111111111111111
1C0000011E1100C1
1111100000C00001
1C00000001100001
1000110000000001
1P11C00011C00001
1111111111111111
