111111111111
1C00E0011001
11000P000001
100000000001
110000000001
111111111111